15 10
1111111111
1200010101
1011010001
1111010101
1000000101
1011111101
1000010001
1111011111
1000000131
1101100101
1000111101
1010000001
1010111101
1010000101
1111111111