15 10 
1111111111
1000000031
1011111111
1000000001
1111111101
1000000001
1011111111
1000000001
1111111101
1000000001
1011111111
1000000001
1111111101
1200000001
1111111111
