10 7
1111111
1211101
1001001
1011101
1001001
1011101
1001001
1011101
1001301
1111111