8 10
1111111111
1031000101
1011011101
1000010001
1111000111
1000010001
1211111101
1111111111